SRSPSRSSRPSRSRPPSRSSRRPRRPPSPSRSRRRRPSRPRRSSSRRPSRPRPPRRRPPSSPSRRRRRRPPSPPPSRRSRRSRPRSRRRSPPPPRSRRRSSSPRSPSPPSRRRRRPSSPSSPRRSPPRRPRPRRRRSSPSRSPSPPSSSPSSPRSPPPPRSRSPRSSPRRPPSSRSPRSSSSRSRSRRRSPSSRRRRSPSRPSPSSPRPSPPRPSRPPPRRPSPPPPRSRRRSPPSRRPRPRRRPRPPSPSRRSPP
SPPPPRRRSSRSRSRRPPRSPSRRPRRSSRPSRPRRRSSSSPRPSSRPSPRRRSSSPRPPRSPPPRRSSSRPSPSPSSSRPPSPSSRPRPRRSPRRPPSRPRPPRRPPRPPSRSSSRRSRSSPSSRRPSRPSRSRPRSPRRPPSRRSRPRPRSPSSRRRSRSRPSRPSSSSSRPSSPRPRPPPPRSRPSPSSPSRPPRPSSSSRRSRSPRRRSPSRSRSRSPPRPRRSRSRSRRPPRRSRPPRPSPRPSRPSRRPR
SRRSPPSRSSPRSRPSSRPPSRPRPSSPPPRPPPPRSPRRRSSPRSRRPPPRSSPSPRRPSSSRPPSPRRPSRSSRRPSRSPPRRPSSSSRSSPPSRSRRPPPRSRRPPRSRPRRPRSPRRRRRRPPSRSSRSSRRPSPSSPPSPSPSSSPSRSRPSSPRPSSRPPPPRRPRRSPRPPRPRSRPPSSRRRRPSSRSPPPPSPPPRPPRSRRSRSSRPPRRRPSRRPPRPSPRRSRRSPRPRPPSSPPSRRSPPRSP
RRRPSSPSSRRPRSSPRPRPPPSSSRRRRSSPRPPRSSSPRPPPSRPPSSRRRSPRRRPRPPRSPPSPRPPRSPSSRRSSPSRSRRPRPRPSRPRPPPSPRSPSRPPSPRSRRRPSRRRRSRRRSRRPSSRPSRRPPPPRRRSSRRPRRSPRSSRPPRSSPSRSSPPPPRPRSPRPRPPRPPPSSPRRPPSRRRSSPPSRRSPPSPSSPRRRPRPPSRRRPPPRRRPPSPSPRRRSSPPRSPPRRSRSSPPSRSSR
SSRSPSSPSPRPSRPPSRRPPSSSPPSSRRSPRPPPPPRSSSPRSSPPSRPRSPSPSSRRPSPRPPPPRSRRRSSSSRSRPSRSPRPRRRPSRRPSRPRPPPSRRPPSRRSSPPPPPSRSRRRRRSSPRPSPRRRRRSSPPPSSRRSRSSPPSPRPSSPRRRPPSRRSRSPPSSPRRPPSSPRPSSRSPSSPPRPSPSPSPSRRRSSPRSRRRRPRSRPSRSSPPSPRSSRPSRSPSSSPSRSPPRRPPPRPSRSP
RRRPRPSRSPPSSRPRRPPRPRPPRRPRSSRPPPSSRPRPPRSRRPSSPRSRPSSRSRSSSRRRRRPRPPSRPSPSSPRRPRRPSSSPSPPSPSSSSPSPPSSSPPRRRRPRPPPPPSRPSSPRPPRRRPSSSPSRPPPRSPSRSRPPSRSRRPSSRSRRRPRSRSPRPRRPRSPSRSPSSPSSSSPSRPSRSPSRRRRRSRPSSRPRPRRRSPPRPSSPSSPRSSPPRSPPPSRPRSRPSSSSPPPPSSPSPRRP
PRRSSRSPPPSRRRRRRPPSSPSPPPSRRSPRPRRRPSRPSRSPSSPRRRPSPPPPSSPSSPRRRPPRPPPRSSSSPRSSSPPPPSSRSSPPPSSSSRSPSSPSPPPPPRPPPPSRRPPPPPPRRSRSSPSRSRPSSSRSPRPPSPRPSPRRSSPSPSRSSPPSSRSRSSRPRPPPPPSSSSRSSRSRRSRPPPSPPRRPRRSSRRSRRSPSSPSSPPPRPSRPPSRSPSPSRRRRPSRSPSRRSRSRRRRSRSPR
PPPPSSRPSPSSRSRRSSRSRSRPPPSSSSRPRPRRPSPSRRPRSRRPRRPSSRPSSPPPRPPRRPRPRSPSPRRSSSPSRSSPPRRPSSSRRSSPSSSSSRPRRRRSRRPRPPRPPPRPPRRRRRRRPPSPPPSSRPRPRPSRPRPRPPSSSSRPPSPRSSRSPRSPPRRSPPPSPPRRRRRSSRRRRSRSPSPRPSRPRSPSPRPPRPRPRSRPPPSRPPSRPSRRRRPSRRPSSRPSRRRRSSSRPRPRSRSS
PRRPRSRRSSSSRRRSSSPSSSSSRPPSPPRSRPPRSPSSRSSPRSPSSRPSSRSPSPSRRRPRPPPPSRSRSSSPPSPRPPPPSPPPSPRRPPSPRSSRSRRPPRPPSSSSSSPSRRRPRRPRSPSSRRRSRSRSPRPPRSSRPRSPSSRRPRSPSPPPSSPPSRPRRRSSPSRRPPPSRPRSRSPRPRRPSRSSRPPRPSPPRPSRRPSRPSRPSPPRSSSSSSPPPRPPPPSSPSRRPPSPSSRRPRPRSSPP
PRSRPPSPRSRPSRRSSPRPSRPRRRRRRSRRRRRPRRSRRSRPRSPRRPSPRPPRRPSRRPPRPSSPRRRPPRRRPPPSPRPRPSSSSSPRRSRSSPRRRPSRSSPRPPSPSPPPRSPPSRSSRSRRRPPPRPRRPSRPSPRPRPSPSRRSPSSRPRPPPSRPPPSSPPPSSRSPPPSPSRRRSPPPSRSPSRPRRPSPPPPSRSSSPPPSRPPRRRRPPPRSSSSSRPSSSSPPSPPPSRPSRSSRRPSSSPRR
SPPRSPPSPRPRSRPRSSRRSRPSSSRPPPPSRSRPSPPPRSSSSSRSRPPRRRSPSPPPPRRSRSPSPSRPPSSPSPSRSRPSRPSPSRRSRSRRRPRSRRSRRRRRRSSSPRSRPRPSSRPSRRPPSPSRRPPRSRRPPRPRPSSRRPSRSPRSSSSSRSSRPPSSPPPRPPSPRPSRRRPSRRRSRRPPRPPSPRRRPRPPSPPRRSPRPRPPSSSSRSPRSPSSRSPSPSSRSSRPRSPSSPPPPRPPPRPR
PPPPRSRPPRPPPRRRPSSRPRSRRSSSSSPSPSRRPPRPRRRSRRSSSPRPSRPPRPPRSPSSRPSSRSSRSRSPSRRRSRSPSSSRPPRPPRSSSSRPSPSSSRPRSRPSPRRRRSSRPRRSSSPSSPRSPPRRPRSPRSPPRRRRSSSRSPRRPRPRSSRRSPPRPSPRRPPPSSPRRSPSRPRRPPRRPPSRSSPSRPSSRSSPPSRSPSSPPRSSSPRSSSRSPRSPRPPSRSPSPPRRPRRSSRRPSSSS
RPSRPPPPSPPPRRPPRSRPSPRRRPPSSSSRPSPRPPRSSRSSRPSRSRRPPSRSRRSRSSRRRPPPSRSPRPSSSPPPPSSPSRRPSSPRPSPPRSPPRRSSSRRRRRSSSSSSRSPPSPSPSSPSSSRSRRPPPPPSRRPPRSRSSSRSRPPPPPPSPPSPPPPSSSSSRPPRRPSRRRRSSPPRPRPSSSSPRRSRSRSRPPPSPSSRRSPPPSPRRRRRSRRRPRSRRSSRRSSRPPPPSSRPSRRSRRRS
RSSPPPSRSRRRPRSPSPSSPSPPRPPRSRRRSRSRPPSRPSRPPSRRSSRPRSRPSPRPPSPSSPRPRPPRSPRRSRPPPPSSPSRRSSRRPPSRRRSRSSPRSPPRPRRRRRRSSPPSRRPPRSRSRSPSRPPSPPPRSPSSRRSPPSPPRRSSRPRSRSRRPPRSRSSPPRPSSSPRPPRPRRPRPRSPSPPSPSSSSPPPRSRPRRRRRSSSPPSSPPPPRPPSRRRSRSSSRSPPRRSPPSSSPPSPRSSS
RSPSSSRRRRRPSPRRSSRRSPSRRSRRSPSSPSRSRRPPRRPPRRRRRRRSPRPSSSPRPSSPSSRPRPSPSSSSPSSPPRSSRPRRSPSSSRSPSRPRRSSPRRRPRSSPPSSPRPSPRRSSRPPRPPSSPPRSPPRSRSPPRPSSRPSSRSRRRPPSPRPSPPPSSRRRSPPSPRSRRPSPPRRSRRSSRRSSSSPRRPRSPSRSRRPSRPRSSRPSPRPRPSPRPRRPPPSSSPPRRSPRPPRPPRPPPRRR
PSPSSRRSPSRPSSRSSPPRPPPSPSSSRSSPSPPPPSPPSPRPSRPSRRRPRSPRPRPSRSRPRRRRRRPRSRRSPPPPPSSRPPRRSSRRPSSSPRSRPSRPSSRSRPPSSSSSPRSPSRPRSSPPRRPPPPSSPPRPPSPRSPPPPPRSPSPPRSRSRPSPPPRSPSRRSSSSSPPPPPSSSRSRRPRSSPPPRSSSPPPRRRPSSRPRSSSPSPPPRSRSSPRRPRSSSPSPRSSRSRSRSRSSSSPRPPRS
RSSSPRRPSSSSSRRSRRRRPPPSSSSPPPPRRRSPSPSPRPSSRSRPRRRRPPPPRRSPPRSPRRRSRPSRRPPSSSSPSPSSPPRPSPPPPPRSRSSSRPSRSPPRPRRPRRRPSRRPSRRPRPPSSPSSRPSSSPPSSPPPRPRRSSSRRRSPRPSRSRPPSSSPRPSPPSSRSRRSPSRRSRPSRPSRPSRPPPSPRRSPRSRPSSPPRSPPPPPPPPSRSPPRSSSSSRPPPPRSSRRPSPSRRPRSPPRP
RSSSPRPPRRSSSSSPSSPPSPRPPRSSRRSSSSSRPRRSSPRSSSPSSPRPPPPRPPSPRRPSRPSRPPSSSPSRPPPPSPSRSRPRRRRPRRRRSRRRRPSSSSPSPPRPSRSPPSRSPRPRPRSRPSPSSSRPPPPPRPRRRPPSSRSSRSRRRSRRSSRSRRRRSSRSRSSRSSSPPSPRRPPSPRSPRRSSPRSPRPPRRRPPRRPRRPSSPSPPPPPRRSPRSPPPSSSPSSSSSRSRRRRSPSSPPRPP
SRPRRRRPRRPSRPRPSSPRRSSSRPPRPRPSRPRRRRSPPRPRPPSSRPSRRSSSPRSSSSPPPPPPPPPRRPPSPSRRRSRSRRPSPPPPPSRPSRSSRSSSRRPRSRPRSRPSSSPPPRPSPSSSPPSRSRRSSPPPSPSPSPPPPPPRRRPSSRPSRPRPPSRRSPSRPSSPPSSSRRRRPPPRPSPSSRSSRRRSPRRPPPPPPRRRPSSSSRRSRRPRPSPRPPRRRSSSRSSRSRPPSSPSRRPRPRPS
PSRPPPPPRPPSSSSPPPRSRRSRRPSRPRSRPSPPRRSSPPPPSPPPPSPRRSSSRPRRSPSSPRRPRSSPRPPSRPSSPPPPSPSSSRSPPSRPRPRSRRRRSRRRSSSPPPSPPPSSSRRSRRSPRSRRPSSSRRSSPPSRPSRPRSRRSSRPSPRPRPSPPRPSSSPSPPSPRRSRRRPSPRPRSSPRSSPSSPRSSRPPRRPSSSSRSSSSSPRPRSRRRSSPPRPPPSPRRSPSPRSSRRSSPRRSPRPR
SSPSRPPPSSRRRRSRSPRRPSSRSPPRRPSRPPSRSSSRRSPRRRRPPRPSPPPRRRPSRRRPSRPPRRSSRRPSSRSRSPPSPRRPSPRRRPRRSRSPPSSRSRRRSSPSSRRRPSPPRSSRSPSRSSSSPPPRPPSRSRRRPRRPSSRRPRPPRRSPPSPPPPSPRRPPSSRPRRRPSPSRSRRRRRRPRPPPSRSPSRSPPSRPSSRPSPSPPRPRRRSRRRPSSRRSPPPPPRPSPRRSSRRSSPRRRPSR
RSRRSSRPRPPRRSSRSRSRRRRSSPPPSRRPPPPPRSRPRSRRRRPRRRPSSSPRSPPPRRPPPSRPRSSSRSPPSSSPPRPPPPRPRRPPRPSPPRPSRSSRSSSRPSPSRPSSSSPRPSSRPRPSRSPSRRSSSRSRRPPRRRPPSSSSRSRSPPSPPSSSPRRPSSSSSPPSSPSSSRRRPRPSPPRSSRRPRPPSPPSSSPRPPRPPSPSPRPSSSRPRPRRRSPRSRSPPSPPSRRRSRPRSPSSRPSPS
RPRSRSRPPRSSPRPPRRPRPSSRPPPRPSPPPRSSRPSSSRSRRSSRSSRPPPSRRPSSPPRSSRSRRRPPSPRRPRSRSPPPRPSSRPPPRPSPRPSSSRPSPRSSSSRRRPSSSSRPRSPPPRSSRRSPRPSPPRSRSPSPSSPRPPRRPRRRPSSPRRPSSSSPRSRPRRSSSPSPRPPPSRRPPRRPSRSRPPRSRRPRRSPPRSPSRSRPSRRRRRSPRSPRSRPPRSPSRPSSRSRRRRSSSSRSPSSS
PPPPSSSRRSSRSRPPPSPRRPSSPSPRSRSPSPPPPPRRSRRRSSRRRSSPPSPPSSRPRSRSSSPRRPPPSRSSRPPPRRRSSRSRPSSSRRRSRRSSRPPRSSRSSPSRRRSPRSSRRSPRPSRRPSRRSRRSPRPRSRRRRSSSPRPPRSRPRPRRSPRPRPSSPSSSSRPRSRSSSRSRPSRPRRPPPSSSSPSSPRPSSRSPPPRRSSRRRPPPPSRSPSPRPSRRSRRPPPSSPRSSPSSSPSRPRRRR
RRRRSRSPSSSSPPRSSPPPPPSPSSSRRRPRSPPSRSSSRPPSSSRRRPSRSPPSPPPPRSRRRSSSRRRRRPPSRSPPRSPPRRRPRPPRPRRPSPPRPRSSRPPPPSRPRPSRRRPRRPPRSRPPSSSSSSRSPRPRRRSPRSSRSPSRRPPSRPPRRPSPRSPSSPRRRSPRRRRRSRRSPSPSSRPSRSRRRRSRSPPRSSSPPRPRSRSRRRSSSPSPSPRRPPSPPPPRPSPSSSRSRPPRRPPRSSSS
SPPRRRSRSSRPRPSRPRRPPPPPRPPPRSSRSPRPRPSRRRSPSRRRPSPSSRRPRPPSSRRSPRSPSPSRRRRSSSPPSSPRRPRRSPRRPPRRRRRSPSSSRRPRSPSRSPPPRRPRPSSSSPRRPRRSRPPRSSRSRSSPRSRSPRRPRPSRRPPSPSSPRRRSPSRRPPRSRRRSSRRRPRRPRSSSPPSPPSRPSPRRPPSPPSPPRRRRRPRRPPPSSSPPPRPSRPRPPSRRRPSRSSRSRPSSSPSR
RSSRSSSRPSSSPPRSPPRSRRPRSRRSSSPRSPPRRPPSPRRPRPSPPSRPSSPSRPPSRSSSRSPPPPPRPSRSPPPRPPRRRSPRPSSPPSSSPSRSRPRSPSPPSRPPPRSPPSRRRPSSSRRPSPPSSRRSSPSPRRRRRRPSSRSSPRPPRSPSSRRRSSRPRPPSPRRRPRSSPSPRPRPSRPSSPPSSRSRRSPPRPPPSSPRRPPSRPSPPSRRPSRPRSPSPSRSSSPRRSPPSSPPPRPPSPPSR
SSPSRPSRRSRRRSRSRSSRRRPRSRPRPRRRPSPRSSRPPPRRRRSRRRPSRPPSSRSSSRSRRPPSSRRRPRPPPRPRRPRRRPPRRSPSRRPSPPPPRSSPSRSSPPPRSPSRRSRRSSPSSPRPSSRSSSPPPPSPSRPSSRRSRSPPSPSPSSSSPRPRRPRSSRRSPPRRPSPPRPRPRPSPSRPRSSRRPPRSPSPPSPRRSRPRRRSRSRSRPPSRSSRRPPPRRSPSRPPPRRSSRRPSRSRRSPSR
RPRSRPSSPRPPSPSRPPRSPPRPPSRRSSSPPRSPPSPSRPSPRRSPSSRPRRSSPRPRSPSSSRPRPRRPRSRPRPSSSPRPRRPPSPSSSRSPRSPRRPSSPSPSSSPSPSPSRRSPPPPRPSPSSSPRPRRPPRRRRPPSPRPPSSRRSRSRPSRSRSRPPSPPSRPPPRRSPSPSPRSRPSRSSPRPSSSSRRPRRSPSSSPPPPPPRRRPRPSSRPPRPSPSRRRPRPPPPPSRRRPRSSSRSPPRSPRS
PSRPSPRRSRRRSRSRSRRRPSSSSRPSRPPRRRSRSRSRRRPSSSRRRSSPPRSPRSPRSPRSRRPRPPPRRPPSSSSRSRPRPPRSRRPRPSRSPPRSRRRPRSRPSRRPRRPPSSSSRRSRRSSRRPSRSPSRSSRPRRRSPSRSSRRRRRPPRRRPPPRSSSRPPSPSRRPPSRSRSRSPRSRSPSSSPSSPPSRSSPSRRSSSPPSPSRPPRSPRRRRRSRPRSPSSPSPRPRSRRRPPRPRPRRSPRPSS
RSRRSPSSPSPRRSPRSSRSPPPPRSSSRPPSPPSPPRRPPSPPRPRRPRRSPPRSRPSRRSRSRPPRPSPRRRPPRPPRSSRSSPPSRPSSPPPRSSRPRSSRSPSSRSRSSPSPPRRPSPSRSRPRPPSSRRRPSPRPSPSPRSRSPSSRRPSSSRPRSSSPPRPSPPPRSRSSSSSSRSPSPSPPSRRPPSPPSRRPRSPRSSRPRSPRSRSPSPRSSRSRRPSRPSPSPPRPRPPRSRSPPSRRRPRSPSRP
PPPRSRRPRRSPRRRSRPPRPPSPRSPSSPPRPSPSRSPSSRRRSPPRPSRSRPPRPRRRRSRSPPRSSRRPPSSSPRRRPSSSPRRPRPRSRRRSSPRRRSRSPSPPPPRSSSRSSRRPSRSRSPPRPRPRPRRSSSPPRRRRSSRSRRPRSPPPSPRPRRPSPSSPRPSSSPSRPSRPRSRPPPRRSSSPSRSPPSRSPRRPRPRPSSSPPRPPSPRSRPSSPSPRSRPSPPPSPPRPPRSSSPSRSSSSPPPS
PPSSSSRSPPRPSSPPPPSRPRPRSRPSSRPPPPPPRPPPSRPRRPRPRRSRRSSRPPSRPRPSSSRRPSRRPRRSSPPRPRPRSRRSPRRRPPRRSSPRRPRPPRRSPRPPRSSPRSSSPRPSSRPRSRPRSRSRPSPPSRRPSPRPSRRSSRSPPPSPPPRPSPSSPPPSPSPRPSPPSPRRSRSRRSRSSSSPPSPSRSSRRSSPPRRPSPSSPRPSPPRSPPSRRSPSRPSPPSRRRPRPSSRSRSRSRPPR
PRPPPPPRPPRSSRRRPRRPRSSPRSPPSRPPPPSPSRRSPSRSSPPSSPRSPPSRPRSRRRRPPSRRPSRSRSSRPRSPPSSSSPPPRPRSSRRPPPPPPRPPRSPPRPPRSPSRRPRSRPPRSPPSPRRPSRSRRPRSPSSSSPRPSRSPSPSSRSSPSSPRRPSPPSPSRRSSRPPPSSRRSPPRSRRPSSPPSPPSSSSSRPSSSSSPRRRRPSRRPPSRPSRPPSRRSPRPPRPPPSRSSSRPRSRPPRSP
PSPRRRPPPRPRPRSSSPRPPRPSSPPPPSPRPPSRRRPSSSRSPPRPRSPRRPSRRPPSRPSSPPSSRSSPPRRSSSSPPPRPSPSSSPSPSPRPPRSSSSRRRSRSSRSSSRPPRPSSSSRRPPPPRSRRRSSPSSSSSPRRRPSPPPSPRPRRSSRPSSPRRPSPSRRPPPPSSSRSPSRPSSSRPSPSPPSPSPRPPPRPSSPSRSRSPPSSPPPRRRSRSSSRSSPPRRSRSRSRPRPRSPRPPSSRPPPP
RPPPRSPPRPRRPPPSRRSSPRRRRSSRRSRRRRRSRPSSPPPSSSPRPRPRPRSRPSPSPRRPSSPRSSRSRPPRPSPSPPRSSRPRRRRSRPSRPPRSRSRSSSSPPSPPRRSRRSRSPPRSPSPPPSSPPRSSRPPPSPSPRSRSRSSSRRSSRSRRSPSRPSRRSSPPPRSSRRRSSRPRPPRPSRSPSPSSPPPSRPPRSPRPPRRSRRRPSRPPSSPPPRSSSSRPRPRPSRRPPSRRPPPSSSSPPPRP
SSSSPSSPPRPSSPPSRPPPRPRSPPPPRRSSPPSPRRRPPPSPRRRPPSRRPPSRRPRPSSRSSPPPPSSSPSSRSPRSPPRPPRSPPPPSSPPSRSSPRPPSPSSPPPRSRSSSRRSSRSSPSPRPSRPRRPRPSRPSPSRRPPRRPPPRRRSPSSSRPRRRPSPSPSRPPPPSRSSSPRSRRPRRSPSPPPPSSSPPPPPRSSSRSRRPRPPRPPSPRPRSRRRPRPPSPPRRRRRRSPPRPSRRSPRPPSSR
SRPRRRRPRPRSRRPRSSSSRRRPRPRPSPSRRSRRPPPSSSSPPSSSPSRSSPRSRPPSPRSSRRSRPRSSPRSSRSSRPRRRRSSRSPSSPPPPPSSRSPPRPPPSSSPSPRRSSRRSPPPPSRPSRPPPSPRPRSPRSPPRPSSRPSSRRPRPSPSRPPSSSRSRSRSPSPPRPPPRSSPPPRRSRPPRPRRPRRPRRSPRRRSSRSPRRRSRRRSSSPPSPSSPRSPPSPRPRPRRPPSSSRRRRPSPRPSR
PPSRRRSSSRRSSRSSRRRSSPRPSRSPSRSSPPSRPPPRPSRPSSRRSPSPRSRPRSPRPRSRPPPSRPRRRRRSPSPPRRSRSSRSSRRPRRSPSRRRRPRSSPRSPRRPSSPPPPSRRPPRSRPSSSSRSPSRRRPRRPRPSRRRRSPRSSRRPRRSPPRPRPSPRRSPRSSPSRRPSRPSRSSSPPPRSSSPSRSPSSPSSRSRRRRRRPSRPRRSPRRPRRRRRRSRPRPPPSRRPPPSPSSRSSSRSRSS
PRPSPPPSRRSPSSRRPSSPPSSPRRSRRSSSPPSRPSSRPRRPRRRSPSRPSSPRSRSPSSRRPRSSRSPRPRSRRSSSSSRPRPSRPPPRSRPRSRRSPRRPSSSRRRSRPPSRPRSRSSSSRSPPRSSSSRPSSRPRRRPPRPRSPSSRRSSPSSRSPRPPSSPPPPRPPPPPPRPRPSPRPSSRPRRPSRRSSRRPSPRSPPPRRRSPRPPRPSRPSPRSPRRSSSPRRRSPSPPRPSPPSPRSSRRSSSSP
SSSPPSPSRSRSPSPSRSPRRPPSSRPSRSRSPPRSPRPRSSPPRPRPPRSRRSPSSSSPSSSRPPSRPRRPSSRPRRRSRSRRPSSRSRSSSSPPRSPRRPRSSSPPRPRRRPRRRPRPPPRPSRSRPPSSRSRSRRSPPRRRRPSSPRSRRPRPSPSSPSRRRSRPRPSSSPRSPSRRRPRPRPPSPRSSRRRSPSSSPRSRPSRPRRSSSSRRPPSPPRRPRSPSPRRRRPSPPSPPSRRRRPSRSPRRRRPP
RRPPSSRPPRSPPSSPPRRSRRRSRSPPSSSPPPPSRRSPRPPRSRSSRPSSRPPSSRPSRPPRRSSRRRRPRSPSSPSSSPPSRRPPSRSPSRRRPRPSSPRSRSRRRSPPSSRSPRPPRSRRRRPSRSSRRSRRSPSRRRSPSSRSRRPRRPPPSPSPPRRSPSRRRRSSRPPRPPSPRSPPPRPRSPSSRSSPRRSSSSPPPPPRRRRPRPSPRSPSPPRPRRPRRPRSPPSPSSRPSRRRPRSRRRSRPRPR
PRPSRSSRRSRRRSPSPRSRPRSSPRRPPSRSRRSRSPRPRSRRRPRRPSRRPRPPSRPPRSRSPRRPRSPPRRSSSRPRRPSSSSPSRPPSPSRPSSPRSPPSSRRPSRSPSRPSPPSRSPSSRSSPRSSRRSPSPRSRPPRPSPPSPSSPPSPPPRRPRSSRRRSSPSRRSRRSRRPPPPSPRPRSSSRRPRPSRPPRPPPPPRRSSRRSRSRRRRPPPSRRRPRPPRPRSPPRRPSSSPPSSRSRSPRPRPPR
SRSPPRSRRPRSSPRSRRRSPSPSPRSSRPSPPSRPSSRRPRSSSSSRSPSPRSRRRRSRRSRPPSPPRSSSSPRSRSRSPSPPRSPSPSRPRRPSPSSPSPRSRPPSRPSSRSSSRPPRRSPRRRSSRSSPSRSPPRRSRPSSSPSSPPPSPSRRPRPRRRRSSSPPPRPSSRPRPSRPPRPPPSRPSPRRSPSPSRRPPRSSRRPSPPRPSSRPRRRPRPRSPSSPPPRRSRPRPPSRSSPRRPSRPPSPPSRR
RSRSSRSSSSRSRSSRRSRSPPSRPPRSRPPSSPPPSPPSPSPRSPSPPRRSPSPRPRPPSSPPSPSPPSRSRRRPRRPSSPRPRSRRSRRPPSSSSPSPRRSPSRRSPSPSRRPSPRRSSRSRPSPRPSRPPPPRRPRRSRSSSSRSSPSPSPSPPRPRSRPPRRSSRPPSPSSPPPSRSPSRSSSSPPPSRPPRSPRSRRPPSSPSSSSPRPSSPRPPRPSPRRPRSSSRSSPPRRPPPRSPSPRRSPSRPPPP
RRSSPPPRSRSPRRPPPSPPPSSRRPSRPPSPPRSRPPPSRPSPRPSSSPSRPRRPSPPPRRRSRPPSPRRSSPRPRPRPSPSSRRRPRSPPPSSRRPSSRSSRRPPRPPSPPSPPSSRPRRSRSRPPRSRSSRRSSPRPSSPRPSRPSSPRSPRPPSSSRPRRPRPRSPSRRSRSRRRPPSSSPRSSPPRSPRRRRPSRPSPSSSRRRPRRSRPRSSRSPSRRPPPRSRPSSRPSRRPSPPPPRSPSSPPRPRSS
RRRPSSSSSPPPPPRSSPSRPRSRSRRSPPSPPPPPRPSRSPRRPSSPPSSSPPSRSRSPRSSPPRPPPPRRPRSRRRRSRPPPPRPRSPSRPSPSRSRPPRPPPPPSPPPRSSSRSSRSRSSSPPPSRSPSSRPSRSSSRSSSSRRSPSRSRPSSPRRSRPPRSRPRPPSSPSSPPRSRPSPPRRRPSPRSPRPPPRSSRSRSRSSSRRRRRRRSRRPRPRSRPPSRSRSRRSRSRPRPPPSRRPPPSPPPRSSS
RRSRRRRRPSRSPSRSPSPSRSRRPRRPSRSSRPSPRSSSRRPSPSSSRRSPRPPSSRRSPSRRPRPSPRPRSPPRRSSPPSRPSPPRPPPPPRRPRRSPSPPSRRPPPRRSPPRPSPRRRPRPSSSSPRSPSRPPPSRPPSPRRRSSPSRPPSRRPRPSPRPRSPSPRPSRRSPSPSSSPSPRPSPPSRPRSPPSRPPSSRSSRPPPRSSPPPSPSRPSRSRSRSPRPRRRSPSPPRRPSPRRSPRPSSRPRSPS
RPPSPSSRPPRSSSPRRRRPRRRSRSSSSRRPPPSRPPRPSRPRRPRRSPPSRPSSRPSPRRRRPRRRRSSPRRSSSSPSRSSSRSRSRRRPRPPPPSRPSSSRPRRSPSPPSSPSPPSPPRRSSRRSSSSRPPSPPSRPPSSPRPRPRPSPRSPPSRPRSPRRRRRSPPPRSSPSPPSSSPPRPRSSSRSRPPRPSPRSSSPRSRPPRRSRPRRRRSSRSPPSRRPSSRPPPSSPSPPSRSPRSPSRSRSSRRPP
PRPRPPPPSSSRRPRRPRSPSRRRSPPSPSSPPSSRSSRRSSRSRPRRPPRSRPRPSSRRRSPSRPRSSSRRPSRRSSRPRSPSSPSSPSPRPPPPRPPSSSRRSSRRSPRRRRSRRRPSSSRRRSSPPPRPSSRPPSRSSRSPRRSSRRSSSSRSSSSSRSPRRPSSPSPRPSRSPRPSPPPSSSSSPRPRSSSSRSRRPPRPRRSSPRPRSSRSSRRSSPRSRSPRPSPRRPPSSPSSPRRRSSPRRSSPPPSP
RRSSSRPRRRSSPRPSRRPSSPSSSSRSRPRRSRSPSSSRRPRPPRPRRPRSPRRSSSSPSPPPSSRPRPPSRRPSPPPPPSSRPSSPRRPRPRSRSSSRPRPSRPSRRRRPPSSSPSRRPPSPRRPPSRPPSSPSPSRRSSSSRSPPRRSSRRRPPPSRPPPSRRSSPRRPPRPPRSSRPPPSSRSRRRPRRPSRRRRPPRPRSSPPRSPPRRRSPPSRPRSPPPRSSSSSSSPPPPRSSPRSSPRSSSPSSPRR
PPPSSPSSPPSPSRRRRRPPRSRSPSPPPPRSRPRPPSPSRSSPPSPPSRSPSRRSRSSRSPSSPPRRPSSSRRSPRRRPSPRRPRSPRSSSRRPSSRPSPRRPPSPSSPSSPRRPRSSRRRPSPRSPRSRSPSSRSPSRRRSSSRRSPSSPSRSSSSPRPPSSPPRSRPRPPRSRPPPSRSRRPRSSRRPPSSRPRRSPSPSRPRPPRSPSRRPRRSPPPRPPRRSRSPRPRRRRPSSRRRRSSSPSSSSSPSPS
PPPPPSSRSPRSPRSRSSSPSRPRRSRPPRPPSPRPSPRSSRRSPSSSPPRPSSSRRRSPPRSSSPRRPPSRRRRPRSPRSRRRSPPSRPRPRSSPRSRPRSSPSRRRRSSSSSRSRRSPPPPSPPRRPRPSSPSRPPRRPPSPSPPRSPRPPPSSRPPRPSRRRRRRRRPPSPSRRSPRSPSRPPRRSRRPPSRRPRPRSRPSSSSSSRRRPSSRSRPSPRRPPRSSSRSPRPPPRPSSRPPRPSRPPPRSPSPS
PSPPPSPRRPPPRSPPRSRSPPPPRRSSPPPPSRRRPSSRSRSPRRSSRPPSRPPRRSPRRPSSRPPSRSPPSSRRPSPPRRRRPSPSSPRSRPPPSRPRPRSSRRPSPRRPPPPSPSSPPPRPSSSRRSPPPSPSSPRSPSPSRPPPRSPPPPPSSSSPSPPRSRSPPPSRSRPPPSSRRRPSSSRSSRRPSRRRRSPSRSSRSSPRPRSSPRPRSRSRRSRPRRSSRSRSPPPRSPRSSRRSPSPSSRPRPPRR
SRSPSPPSRRSPPSPRRRSPRSPRRPSRRSSSPSSSPSSPRPRPRRRPRRPSSPSPRRRPPSSRRSRRRPPPPSRPSSSPSRRSPPRPPRSSRRPPRRPSPRRSPSRRPPRPSRPPRSPPSSRPPSPSPPPRPPPPRPSRRRPSPRSRRSSRSRPSRPPPSSPSSPRPPRRRRSPPSSRPRPRPSRPSRSRRSRRPPSPPSRSPRRRSPSSRRPPPSPPSRRPSSSPSPPSRPRRPPSSRSSRPSRPRSRPSSRPS
RRRPSPSSPRRRSSPSPPSSRRPSPPRPPPPSSPRSPRRPSPPSRRRPPRRRSPPSPRPRRRRSRSSSPRSSRRSRSSRRPRSPPSRSPSPSSRSSSPSSRPRRRPPPRSRSRRSSPPSSRSRSPRPSPRRSSSPPRSPRSPRPPRPRPPSRPRPRPRSPRSSSSSSPSSSPRSPPPSSRSRRSRRRSRPPRSRSSPRRSSRSSSSRRRPSPSRPSSRPRSSRRPPRSSSSPSRPSSRPSSSSPRSPPRSPPRRRP
RSPRSRPPSSRRRSRRSSPSRPPPSSRRPPSSSSSSRRPRRSRPRPRPSPRSPPSRRPRSRSPSPSPPSRRSRPPRSPPSSRPPPSRSSRPPPRRRSRRPSSSSPRRPSRRPPRRRRPPRPPPSPRSSPRSRRRPRSSPRPRSPSPPSSPRPRSPSRPSRRPRPRSPRSPSRRPRPRRRSRSPSPSRSSRSPSPPRPPRRPRRSPRRPRPSSPRPRRSPPSRPRPRRSSRSPPSPPPSRSRRRSPPSPRSPRSRRR
RSSPRRSSRPPSRPPRRSRRSPRSPRPSSPRSSRPPRRRSSPRPPSSPRSRSSSSRSPSPSSPRSPRPRSPPPPRSRPSSPSRPSRRSSRRRSPSRRSPPRSSPSRSRRSRRSRRPRRPPSRRSPPSPSPSSRPSSRSSSPSRRSRRPRRSPPSPPRRSRRPRPSSRPSRSRSPSSRPRPSRSPPRRSRSRRRSSRRPSPRPRPRPRSPPPRSSSRPSPPRSRRPPRRRPSRSRSRPPRSPRRSSSPRSSPRPSPP
RSPRRPSSRRPSSSSRPSSSPSPRSRPPRPRSSPRRRSSPSPRPSRRPRPRPRSSRSPRSRSSSSSPRRPPRSPSPRPRRPSPSPSPPPPRSRPRPSRRSSRRPRSPSSRPSSRPPRSRPSRPRSRSRPRRRRPPRSPPPRPPSRSPPSRSSSPSSPSRSRSSRRPPRSSPPSSRPRSSPPSRRSRPPSSRPSSPSPPPPRSSRSPPSSRSPSRPPRSPPSPRSRPPRPRRRPPRRPRSSPRRRSPSPPRSRPRRP
SSRSSSSRPRRSRPSRSPSPPSRRPSSPPSPSPRRPSPPPPPPPPSPSSRSPPSRSSPSSSSRRPSRRPRRRPPRRPRSSRPPRRSSRRRSSSPPSRSRPPRPPRPPPRSRSRSRSPSRPRRPPPPPPRRRSRRSPRSSPSPPRSPSSPPSSSSPSPSSPPRPSPSSSPPPSPPRRSSSPRSPPSSSPPRRSRRPRPSSRPRSSSRRRSSPSPSRRPPSRRRSRSRSPSPPSSSPPPPRRPRRRPRRRSPRPSPSR
RSPRPPRPRSRRPSPPPPPRRRSSRSSRSPPPRSRSPPSRSPSPPRSPRPPPPSSRSSPSSRSRPPRPRRSSSSPSSPRRPPRPSPPRSRPSSSPSSPSSPSSSPPPSSSRRPRSSRRSPPRRRSRRPRSSSPSPPRSRPSRRRRPSSPSPRPPSRRPRSSSSPSPRSRSSRPPRPPRSPPSSRRPRRPRRSRPRRPPSRSSRRRRPSSPPRSPPRSSSRSRPRSSPRPRRRSSSSSRSRPPRRSPPPSPSRRRPS
SRPPRRSSSRRPPRPPSRRRRRRPSRRRPRRRSSRRRSRPSRSPPSRPPRSRSPSPPPPSSPSSSRPRSRPPPPSRPPRPPSRRPRPSSPRRRSPRPRPRPRSPPRRRPPRRRPSRPPSSSSSSPPRRPPPPSPSRRSRSSRPRPPSSRPRPSRRRSSPPRPSSPSPSSSPRPRRSSSSPSSPSRSSSSPRRPPRPRPRPSRRPSPPSPPPSSRSRRRPSRPSPRRRSRSPSSRRSRPPPRRPPSPRRRSRPSSRP
RPPRSSRRPPSSPRSRPSRSSSPPSSRSRSPSPPPRPSSRRRPRSSRPSSRSPPPRSSRPPPPRSSRRRRRRPPRSRSSSSRPSRRPRRSSSRSRPPSPRPRPSRRPSRSRRRPRPSRSSSPRRPPSPRPRSSRPSSSPPSRRRPSPSPRSRPSSSPRRSRRSPPSRSSPPSPRPRPSRSSRSSPRPSRRPSRPSRSSSRRPPPPSSSSPSPRRPRSSSPRSSPRPRPPRRPPSRRPRPPPPPRPSPRPSRSSSRP
PPPRRSRRPPRSSRPPPSSRSPRRRRRSPPSSPPSSSPRPRPSPPRSPPSPPRSPRRRSPRSPPSRRSSRSPRRRPSRRRPSPPSRRPPRPPSRSRRSSRPSRSRPPSPRRSRPPRRRPSRSRRPRSSSSPSRRSPPSSPSRPRPPPPSSPRRRRRRRRRPSSPSPPRRRPSRPSSRSSPSRPSPSPRSPRRSRSSRPSSPPPPRPSRPPSSRSPSRPSPSRRSPPSPRPSPPPSSSPPRRRPSRRRSRPSSRRPR
SRSSRRSSPPSRPPRRPPPSRSSRRSRSRPPSPSPPSPSRSRPRRSSSPRRSPPRRSSSPPRRPRPRSPSPRSSSRPRRPSSPPRRSPRRRSSPSSRRPSRRSRSSRSSPSRRPPRRRRRRRRRPRPRRSPSPRPRSSPPSRSPPPPSRRSSRRSRPSSSSSRRRRSPSSSSPSSSPPPPSRSPPSRRPRSRPRPPPRSRPPSRPSSRSPRRRSPPPSSSRSPSPRSSPRRPSSSSRRRRRRRPRRRRSPRSRSRS
PRSSSPPSRSRPRPSSRRSRRSRSPPPPRSRPSPPRPSPSPSPSRRRPRSSPPRRPSRRRRPRPSSRPSRRRSPPSRSSPPPPSSPPPSPSRSSSSRSRPRRPRSRPPSSSRPRSPPSRPRSSSSRPPPPSPRSPRRSRRSPPPRPSPSSPRPSSPSSSPPRSSRSPRPPSRPPPRRSRRSRSPSPSSRSPPSPRPRSSPSSPPRPPSSPSPSRSRRPRPRRRPSRSPRRPSSPSSPPRPRSRSRRRSRSRRPSRP
SPSRPSPPSPRPRSPRPRSSSPRSPSRPSSSRPPSSRPSPRRRSPPSPPPRSSPRRSSRRSRSSSRRRPSPRPPPPPPSSPPPRRRRRPRSRRPSSPPSRPPPRRSSRRRPPSSRSSPPRPSPPRSRSRPPPRSRRSPRRSSRSSRRPRSRRSSRRRSPRPPRPSPPSPPSPRPPSSPRPSSSPRPSPPPSSPPPRSSRPPPSSSPRPSSSRRRSSRPRRSRPPRPSPPPSRRRRSRPRSPRRPRRSRSRSPPPSP
PPSSPPSSRPSPSRPRPPSRRPRPPPPSPSSRPPSSSSRSRPPSSSSPRRSSRPSPRSPPPSRSSSPSSPRRPPPRRSRRPPSSPSRPSPPSPSPRPRRSSSPSPPPRSSSSSSPRSPRSSSSSSSSRPPSSRRRSPSSSRPSRSSSSRPRRSRSPSSPRSPPPPPRSSSPPRPPPPPSSSPRSPSPSSPRRSSRSPSSPSSRRPRPRRSPPSPRSSSPRRPRSSSRSSSSSSPSRSSSSRSRRSRRRPPRRRSRS
SRRRRRSSSSRSRSRRRSRPRSRRSPPRSPRRSPPSPPPRPSPSRRRRSRPRSPSRSSRPPRSPRSPPPPRRPPSRSSRPSPPPRRPPSSSPPRRSRSPPPPSRRPPSSPRPRSRRPPPPRRRSRRSSPSSRSSRRRRPPRRPSSRPSSRSSPPRRSPPPSSSRPPSRSSSRRRPPPSSSRRRPRRSSSSPSSRRPSSPRPRRPSRRRRSPSRSRPRPRSSPPRRSSRPPRPSPRSSPSRSRSSRSPPSRRRRRSS
SRSRPSSRPPPSRPRSRSSPPPRPPRPRRSPPRSRPRPPPRSPPRSSSSPSPRSPSSPSSRSPSRRPRSSSPSRRRRRSRRRSRRPRRPRRRPRSPSSPPSPSPPRPPRSPRPSRSSPPRPPRPPSRPPSSSPSRPPPRSPRSSPRSSPSRRRSRPPRPPPSSPSRRRSPRSRSPPSSSRPPSPSSSRPRRSRRRSPPRRRRPPSPSRRSPRPSPRSSRSRSRRRPPPRPSRPPSSPRRPSSRPPSPSRRPPSPPP
PSRRSSSRRRPRPRPPPSRPPSPPRRPSRSRPRSPRRPPSPSSRSPSPSPPRSRPRPRRRSPRRPPSRSSPSPPPRPPRPRSSSPPPRRRPSRSRSPRPRRSRRPRSSRPSRRPRRPSPRPRRPRSPRRPRSSSSRRSPPRRRSRRSRRSPSRRPSSPRSSSPPSRSRRRRRRRPPPSPSRRPPSSPSPPSSPRRRRPRRPSRRPPPSPSPRPSPSRPPSSSPRRRSPSPPSSPRRSRRRRSPSSRRSRPSPSPRR
RRSSRRPRSSRRSRRRPPSPRSPRSRPRPRPPPSSRRSSPPPPPPPRRPSRSSSPRSSRPRSSSRSSSSPSPPPPRPSSSSSSSRSSRPRRRSRSRPSRSRSSRPRPSPPSSSPPSRSPRRRPRPRRRSRSSRSRRSRSSRPRPSPRPPPSRPRRPSPSRSSSRRSRSPRRRSPSRPSPRRRPRSPRRSRRRPSPSSSRSRPSSRPRRRRPSPSRSPPPRRRRSPRSPPSPSRRSPRSRRPPPSRSSRRSSPPRPS
RRSRRPSSRSPSRSPRRRRPSPRSPSPPRRPRSRPRPSRSRSPSRPPRRPPSSSRRSPRPRPPRRRSRPRRPSRRSSPRSRRRPPRRSSSRRSRRPSSSPSRPSSPRRPRPRPPRSSRSSPPPSPPPPRSPPSPRRPSRPPRPSSRPPSRPSRRPRPSSRSSRSRRPSRPPRSRRPPSPPSPRRPPSSPPRSPPSRRPPPPSRSSPSSRPSRPPRRSRRPSSRRRSRRRPRRPSSSSSPPPRRSSRRSRPPPRSPP
PSRPPPPPPRPRPRPSRRPPRRRRSPSRSPRRSSSSPSSPPRSSPRPSSPPRPPRRSPSSSRPRSSRSSRPSPSRRRRSRSSRSSRRSPRSSPPPSRRSRSSRSRPRPSSPSRRRSPPPRPPPSPRSRSPSSRPRRSRRSRPRPPSRPPSRSSSPRRSRRRSPPSRRSRPSRSPRRPRRSSRRRPRSSRRPRRPSRRPSSPPSPSSRRRRPPPSPPPSRRSRPPRPPPPRPRPPRSRSPRSRSPSRSPRSPRSRRP
SSRSPPRRPPPPRSRSPSSPRRSPRSPPSSRRPSRPPRSSRRRPRPRPSSPPRPPPPRSSSRPRSPPPRSSPSSSPPSRSPRSRRRRRPRSRSPRSRSSSRRSSRSPPPSSSRPRSRSRRRPPSSRSSPRPSSSPRPPSPSSSRPPSSRPPSPRRRSRSPPSRRSPSRPSRPSRSSPPRSRRSRSRRSPPSPPRRPSSPPPPSRPPRPRSPPPSPSRRPRSSPSRRSPPPSSRRRSPPSSPRRSPSPRPSRRPRSP
SRSRPSSSRRSSPRSSSPSSPSSPSSRSSRPPSPSPSRRRPRRRPPPSRPPRSRSPSRRSRRSSRPSRPPSRPPRSSSPSSPSSSPRSPSSRRPPPRRPRSPPPSPPSPPPPRPPPRSRPPSPRPPSPRSPRRRPSRPSPSSPRRSRRSPPRPSRRSRSRRPPRPPRSPSSPPRPRPPPSRSRRPRRPPSRRPSRRRSRRSRSSPPRPRPSPRPPSPPRSSPSRSSPRPRPRPSSRSSSRSSPRRSSRPPRRRPPP
PSRPSRRSRSRRRPPSRRRSSPSSRSRRRPPRRSPSRRPSSSPRRRRPRSPRSRSRPPPSPSRPSRPPRSPPPRPSPRPRPPPPPPSPPPRSSRRRPRRRPRRSRPPRRPSSSRSSSRRRPPRRPRRRPSPSSRRPSPSPRSRSSSPRPPPPPRRRPRSRSPSRRPSPRSPSPRRPSPSSRRSRSRSRRRSSPRSPRRSRPPPRSRPRPSRSSRSPSSPRRRSRSRPPPPSRRPRRRRSSRRPPPRRSSPRSPRPP
RSSPRSSPRRSRRRPPSRRSPPRRPPPSRPPRSPPPRSSSPRSSPPRSSPPRRRRPPSPRSPRSPPRSSSSPPRSRSPRPRRSSRRPRPRRPPPSPPPSPRPRRRPRPRRPSSPPSPSPRPPSSPRSRSSPPSPRRPPPSSSRRRRSSRPSRSSRPSPSSRPSSSRRPRRSRRPRRRSPPSPRRSPRSSRRPRRRSRSRPRPRRPRPPPSSRPRRRSRPRSSRPRPSSPSRSPSRRPRRSRPRPSSRSPRPPRRSP
SRSRRRSSSPPPRSPPPSSSPPRPRPSSRSRSRRPRPPSRSSPSPPRPRPPRRSRRRPRSPSSRSSPPSSPPSSSSSSSRPPPSPSRSPRSSPPPPSSRSSPPRSPSSSSPPPPPSSRPPPPPPSRSRRPPRSPPPPPRRRSRSSPSPPRSRSPSPSRSRSSSPPPSPSSPSRRPPRSSRRRRPPRRPRRPSRPRRSPSPPPSSPSPRSSRSPRSRPRPPSPRSPPSRRPSRPRSSPRPSRPPSRPRPRRSSPRRP
PPPSSSSPPSSPRRPSPSPRPSPPRRRSRRPPRRRPSRPPSPRSPPSPSPRPSSSRRSSSPSSPSPPSSPSSRRPRPSPSSSRSRSRPRRRRRRRSPSRRSSSPRRRRRSSRRSPSRRPSSRRSSRSRRRPRRRSPPPSPSSPSSPPPRRRPPRRRSRPSPPPPRSRPRRSPPSPSRPPPRRPRRPRSRSSSSRSSPSSRRPPRSPSPPPRRRRSSSSRPSSPRRSPSRPSPPSRRPSSSSSRRSSRPPPPPPRRR
SSRSPPSPSRRSRSRPRSPPSPPPPSRRRRPSRRSRPPRSSPSRPRSRSPPSSSPSPPSRRPRPSSRRRRRRRRRSPRSPSRSSRRSSSPPRSSSRSSRPSRSRSSPPRPRSSSRRSRPPRPSSPSPSRSPSSRPRPPRSSSRPRPRPSPRSSRSPPSPPSRSSSPSPSSRSSRPPPRRSSRSSRPSPSPRRSPSSSRPSSRPSPPSSSSSRSRSPPPPSSSRPPSSPPSPRPRSRSPRRRRRRSSSSRPRSSRPR
RPSRSSSPRSPPRPSSRRRSSSSRPSRRRPPSRSSPRPPRRSPPPPSSPPSSRSRSSRSSPPSPRSSRSPSSSSSSRPSPPSSPPPSRRSPRSRPSSSSRRPSRSPRSRPSPPRPSPRPRRRSRPRSPRPSSSRSPSSPSRSRPRSPSSRRRPPPPRSPRRPRPRRSPPPSPRSRPPPPPRSRPRRSRRRSSSSSPSSSPRPRRPPSSRSPRRRSSRRPRPRSRSSRSRSSRPPRRPPPSSPPRPRSPRRRRPSPP
PPRRSSRSRSRSPPRPRRPPPRSSPRPRSPRSPPPSSSSPPRSSRPRSRRRSSPSRRSSRPPSSSSPSSSPPSRSRPSRRPPSSSSSPPSRPPSSRSPPRRPRPRPPRSPSRRSPPPSRSPSSPPRSSPPSPPPPRRPSSSRSSRPPRSSRSPRRRPPPSSRPPSPSRRSSPSPPPPPRPSRSSRSPSPSSPPPPRSSSSRSPRRRSPRSPPRRRPSPPPRPSRRPPRPRSRRRRSPRPPPPRSRPPSPRPRPSPS
RPPPRSSRPSSRRPSPRRSPPRPSSPPRPSSSSSSRRSSSSPSPRPPRPRPPPRPSRSRPSRRRRPSSRPPRSSSRPSPSSRSSPPPSSPRPRPSRPRSSSSRRPPSPPRPRRPPRSSSRSSRRRRPPSRPRPRPPPSSSSRRPRRSRPSSRSRPRPRSPSSSSSSRSPRPRRSRRSSRSPSPPSPSSRRPPPRRSPRRPSPSPRRPPPRSRPRSSPRPPSPRPRPRSRRPRPPRSPSSRSPSSSPSRSPSPRPRR
RRSPSPRSPPRPSRSSRPRPPRRRSSSPSSSPPRRPSSPRRPPPSPSSPRSPSPRSPSSSRRPSRSPRPRRSPPPRRRPRPSSRPRPPSRPRPRRPSPSSRPPRSRRSPSPPSPSSRPSRPRSSSRSSRSSPRSRRPRSRPPPRPSPSRSSSSPRPPSRPPPRRSPRPPPPSRPSSSSPSRPSRPRPRRSRPSPPPSRRSRSRSSPPRPRSRPSPSPSPPSPPRRPPSRSSSPSRSPRSRSRSSRPRRSRRRRSSR
SRPSSRPSRSPRSPPSRPSSRPRSSSSPRRRSRRRRSSPSSPSPSRPRSSRSSSPSRSSPPRPSPPRSSRPSRSSPRRRRSPPSSRSSRRSRPRSSRRPSPPRPRPRRPRPSSRPRSSPSSRPSPPRRPRSRSRRSRRRPPSRSSRRSSPRSSSPRRSRSPRSPPRSRRPSSRSPPRPRSPSSSSPPSRRSRPRSPRSRRRPRRPPPRSPSRPPRSSPRPPRRRSRPRPSPRSSRSRRRPSPPRSSRPPSPRSRSS
RRRPPSPPRPRPPSPPRPRRPSPRRSRSRPRSSSPPRPPRSPRRSSRPSSRRPSSSRPSPSSSPPPPSSPPSPPPRPSPRPPPPRSRPRPRRPRSRPSPSPSPPRRPPPSPSRRRRRPSSSRPSRRSSSSPPPRPRSSSPSPPPPPSRRSPSRSSRSPPRRRPPPSPSSRRSRRPPRSPRPPPRPPSSRSRPSPSPRPPSRPPPSRPPRSSSSRPRSPSRRRPRSPPPRSRSRPSPPSSPRSPRSSRPRSPPSPRS
SRPSRSPPRSPRRSSPRPSSPPSPRSPRSPSSSRSSPPPRRPRSPRRRSPPPRPPPSRSSSRRPPRPRPRSSPRPPRPPSSRRRPSRSSPPPRRPRSSSSSRRRRPPSSRSRRRPSPRRRSSRPRPPRRSSRSRRSPRSPPRRRPRSSRSSPRRSPSSRRPSRRPRRPPRRRRSSRPSRRRRSSSSRPSPSPPSRRSRSSPSPSPSPRPRSRRRPPPSPPSSPPPSRPRSRRPSRSPRRRRPRRRSPSRSRSSPRS
RPRRSSRRSPSSRPPRSPRPSSSRSRSPRSPSPRPRRRSPRPPRSRSRPSRRSSRRRPRPSPRSRPSSRRPPSRPPRSRPSRRSRRPRSPSRSSRRRRPSPPSRPPSSSRRRPSSSPSPPRRRSPSPRPPSPSRSPPSSPPSPSSPPRSPSPRSRPRSRSPSPRRRPRSPPRPSRSRSRRRSRRSRPRRSSSRPSRRSRSPPPRPPPPPSSSRSSPSRRSPRSPPPSRPSSRPRPSPRRRRRRSPPSPRPRPSSRS
SPPPRRPRRPPSPRRPSRPPRRRSRPPRSPSPSPPSPSPPSRSPRPSPRSPPPSSPRSSRRPPPRRRRRRPSPPSRSPPRRSSPSSSRPPRPPRPPPSSRSPSPPSRPPSSSSSSRPRSSRRSPSPRSPSSRSPSPRSRPPSPSSPSPRSPRPPRRSPSRPPRRSPRPPRRPPPSRSRRRPSSSPPSSSRSRSSPPSPPRRRPRRPPPSRRPRPPSSPPPRPSRSPRRRPRSRSRSRSPPRPPRSSSRRSPSPRRP
RPSPSRPSRRRPRPRPSPSSPSRPPPSSSSRPSPPPSSPRSSPSSRPRPRSSPSPSRPSSPSSRPRPRRSPPRRSSSRPRSSSRRRSRSPPRRPRPRPSSSSSRPRPPPPPPSPSRRSSSSSPRPSPSRSPRRRPSSPSPRRSSRSPSPSSSPSSRPPPRSPPPSRPSSPPPPSRRPPRPRRPSPRPPPSPSRRPPSRPRPRPSRRRPRRPPRPSPSPRSPSSSSPPPPRSSRRSSSSSRRPSPRSSPRPSRPRPR
RRRPRSPRRPSSRPSPRRSSRSRPPRSRRRPRSPPRRSRRSRSSPPPSPSSRRPPPRRSSPPRPPSSSPSSSSRPPRSPRPPPSRPPRSSPPRSPRRPPSRPPSSRSPSRPPRRPSPPSSRSRRPPRPSPSSPPRSPSPSRPPRPRSSSRRSSSPSPRPSPSSRPPSSSSSSRPSSSSSPPRSRRPSPSPPRPPPPPSRPPRSRPPSSRPPSPPSSPSPSPSRPSRSSRRSPPPPSSPPRSSRSRSPRPRPSSSRP
RPPRPRSPSSSSSRSRPSRSPRSRPRRPRRRRSPRSPPPSPPSPSSSRSRPRRSRRPRSSRRRSSRRRRRPRSSSSRSRPPRPSPRSPSRPPSSRSRRSSSSRSRPPRSPPRSPPRSPRRSRSRRPSSSRRSRSRRSSSRRSSRPPRSPRPRRPRRPSPPRPSSRSPPPRPRSPSRPSSRPRPPRRSPRRRRRPPRRPPRPPRRRRSSSPSPPPSRPSPPSSRRPPPRSPPSPPPSPPPSSRRPPRRSSPSSSRPR
RSRPSRRPSPSPPPSSRSRSPRSPSPPPSRPPPPRRPRRPPRSSSSRRPSSPPSSRRSSPRRSSSSPRRSRPRPRRSSRPPRSRRPPSPPRSPSPSPSRPSSSSSPSSSRPRRRRPSSRPSSRRSRRRPSRSRRSPRSRPPSRSSRRPSPRSRPPSPPSPRSPRSPPPSSSPSPRPRPPSSRRPPRPPSSRPRPRSRSSSSSPRRRRSRSPPPSRPSSSRRSRSSSRRSSPRRSRPRSPSRPSPRRRSPPPRSRSR
SPSRRPSRPRRPRRSPSSRSRPRPRPSSSPRPPSSPPPRSSPPPRSSSPRRSPSRSRRPRSPSRSPSSRRRPSPRSSRRRPPRPRSSRSSSPSPPSRSPPSRRRRPRPRSPPRRPRSPSRPSSPSRSSRPSPSSSSRPPSSSSPPPSSSPRPPSSRSRSRSRSRRPPPSPPSRRRRPRSPPPSPPRPSPRSPPPPPPSPRPSRPRRPSSSSPRSRSPSSPPPPSPPRPRPPPRPSPSPRRPRRPRPPRRPPPSPPR
RSSRRSSSRSSRSPSSPSSSPPRRRRPSRRSPRPRRPRSRRPRRRRPRRPRRSSSPRRRSPRRSPPSRPPRRPSPPPSPRPRPRSRPSSRPPPRPSPSRPPSPPSRPRRSPRPPPSSSPSPRSRRRPSRPSPPSRSPRRRPSPRSSRPSPPSSSSPSPSRPRSSPSSRPSRRPPSSRSPSSRSRSRSPPSRSRSPSSPPSSSPRRPSRPSSPPSPPRSRRRRPRRPRSRRPRRSRSRRRSPPRSPPPSPRRSSPRP
SSRPPRRSSSSSPSRPSPRSRRPRRRSRPSSSSSRPSSPSSSSPRPPRSRPPRRPSSRRSSSPSSSSPSPPRRSPSRPRPRRSSSRRPPSPSPRPSPRSSSSRSPPPPRSRPSPPRRRRRPSRSRPRSPSPRSSPRSPRSPRSPSSPRPRSRSPRSPSRRPPSPSRSSRSPPPRRRRRPPPPSPSPPSSSPPPRSSRRSRPRSRRSRPRSRPPRPPRSPRSRSRSPRRPSPRRRRSPRSSSSRSSSRRPSSRRPPS
RSRRPPRPPRPRPSPSSRPRRSPSRRSSPRSSRSRRPPRSRPSRPPSSPPSPRRPSSRRPRRRSRSPRRRSSPSRSSSPSPPPSSSSPSSSSPPPSPRPPRRSSPPRPSPSPPPRPSPPRSPSRSPRRSPRPSRSSPSSRSSSRRSPPSPRPPSSSSSPPPPPPPPPSPSRPSRSPPPPSPRRPPPPPPSRRPPPPSPPPSPPSPPSPPPRPRRSRRPRPSSSRRPRPPPPPPSRPRSRRPSSRRSSSRRSRRRPR
SRRSPPRPPPRSPRSSSPPSSPRRSSPRRRRPRSRRRRSPRSPRPSPSSRSPPRSPRSSRPRRSPRPPSSSSSPRRPPSRPRSPRRRSPRPRSRSRPSSRRSSSPRRSSRRSRRSRRRPRSRSPPPRRPSSPSPPSRPPPSPRSRRRRPPPSRSPSPPRPPPRRPRRRPRSSPSRRPRRSPRRSRSSRSPSPSRSPSSPSPPSSSPRPSRPSSSSRSRRPRSRSRSSRPPRSPRSPSPRPRPRPRSSRSSRRSRRR
RRRRPSRPRPPRSPPRPSRPPPPPSPPPPRPRRRRRPSPPRSSSRRPSRSRSPRRPRRSPRSSSRRRSSPRRPRRRSSRPRRRSRPPPPRRSSPRRSPSPSRRSSPPSSPRRRRPPPRSPRPRPRSPSSPPPPSSSSSPRPRPSPRSRRPSPSSRSPRSPSRPRSPRPPRRPSSSPSRPPSSPSSRRRRSRRRSRSPSRRPRRRRPSRSRPPPPPRRRPPSRSSPRPSPPSRRRPPPRSRSPRPPSSPSPRPPSPP
