RRRPRPRPRPRPRSSSSSSSSSSSSSSSSSSS
RRRRRRRRRRRRRPRPRPRPRPRPRPRPRSSS
PRPRPRPRPRPRPRPRPRPRPRPRPRPRPRPS
RRRRRPRPRPRPRPRPRPRPRSSSSSSSSSSS
PRPRPRPRPRPRPRPRPPPPPPPPPPPPPSSS
PRPRPPPPPPPSSSSSSSSSSSSSSSSSSSSS
RRRRRRRRRRRRRPRPRPRPRPRPRPRPRSSS
RRRRRRRRRRRPRPRPRPRPRPRPRSSSSSSS
PRPRPRPRPRPRPPPPPPSSSSSSSSSSSSSS
RRRRRRRPRPRPRPRPRPRPRPRSSSSSSSSS
PRPRPRPPPPPPPPPPPPPPPPPPPPPPPPSS
RRRRRRRRRRRRRPRPRPRPRPRPRPRPRSSS
RRRRPRPRPRPRSSSSSSSSSSSSSSSSSSSS
RRRRRRRPRPRPRPRPRPRSSSSSSSSSSSSS
RRRRRRRRRRRPRPRPRPRPRPRPRPRPRSSS
PRPRPRPRPRPRPRPRPRPRPRPRPRPRPRSS
RRRRRRRPRPRPRPRSSSSSSSSSSSSSSSSS
PRPRPRPPPPPPPPPPPPPPPPPPPPSSSSSS
PRPRPRPRPRPRPRPRPRPRPRPRPRPRPRPS
RRRRRRRRRRRRRPRPRPRPRPRPRPRPRPRS
PRPRPRPRPRPRPSSSSSSSSSSSSSSSSSSS
PRPRPRPRPRPPPPPPPPPPPPPPSSSSSSSS
PRPPPPPPPPSSSSSSSSSSSSSSSSSSSSSS
RRRRRRRRPRPRPRPRPRPRPRPRPRPRSSSS
RRRRRRRRPRPRPRPRPRPRPRSSSSSSSSSS
PRPRPRPRPRPSSSSSSSSSSSSSSSSSSSSS
RRRRRRPRPRPRPRPRPRPRPRSSSSSSSSSS
PRPRPRPRPRPPPPPPPSSSSSSSSSSSSSSS
RRRRPRPRPRPRPRPRPRPRPRSSSSSSSSSS
RRRRRRRRRRPRPRPRPRPRPRPRPRPRPRSS
PRPRPRPRPRPRPPPSSSSSSSSSSSSSSSSS
PRPRPRPRPPPPPPPPPPPPPPPSSSSSSSSS
PRPRPRPPPPSSSSSSSSSSSSSSSSSSSSSS
RRRRRPRPRPRPRPRPRPRPRPRPRPRPRSSS
PRPRPRPRPRPRPRPSSSSSSSSSSSSSSSSS
PRPRPRPPPPPPPPPPPPPPPPPPPPPPPSSS
PRPRPRPRPRPPPPPPPPPPPPPPSSSSSSSS
PRPRPRPRPRPRPRPRPPPPPPPPPPPPPPPS
RRRRRRRPRPRPRPRPRPRPRPRPRSSSSSSS
PRPRPRPPPPPPPPPPPPPPPPPPPPPPSSSS
RRRRPRPRPRPRPRPRPRPRPRSSSSSSSSSS
RRRRRRRRRPRPRPRPRPRPRPRPRPRPRSSS
PRPRPRPRPRPRPRPRPRPRPRPPPSSSSSSS
PRPRPPPPPPPPPPPPPPPPSSSSSSSSSSSS
PRPPPPPPPSSSSSSSSSSSSSSSSSSSSSSS
RPRPRPRPRPRPRPRPRPRPRPRSSSSSSSSS
PRPPPPPPPPPPPPPPPPPPPPPPPSSSSSSS
PRPRPRPRPRPRPPPPPPPPPPPPPPPPSSSS
RRRRRRRRRRPRPRPRPRPRPRPRPRPRSSSS
PRPRPPPPPPPPPPPPPPPPPPPPPPSSSSSS
